111111111111111111111111111111111111111
1CE10C001C0E111111111111111111111111111
1000K1101100111111111111111111111111111
10P000000000111111111111111111111111111
111111111111111111111111111111111111111
