1111111111111
1CE10C001C0E1
1000K11011001
10P0000000001
1111111E11111
