11111111111111111111
10000000000000000001
10000000000000000001
10000000000000000001
10000000000000000001
100000000C0000000001
10000000000K00000001
100000000000000P0001
10000010000000KKK001
10000100000000CEK001
10000000000000KKK001
11111111111111111111
