1111111111111
1CK10C001C0K1
1000K11011001
10P0000000001
1111111111111
