1111111111111
1CE10C001C0E1
1000K11011001
10K0000000001
1111111111111
