1111111111111
1CE10000000E1
1000011111001
10P011C0000K1
1111111111111